%%%%%%%%%%
%        %
% ... ...%
% . . . .%
% . . . .%
% . . . .%
% . . . .%
% . . . .%
%P. ... .%
%        %
%%%%%%%%%%